1,1,2,1,0,1,1,0,1,1,1,0,5,1,1,0
1,4,5,1,3,1,0,0,0,4,1,1,0,1,2,1
1,1,1,1,1,1,1,1,5,1,1,1,5,1,2,1
3,1,1,1,3,5,5,0,1,1,1,2,0,1,0,1
1,1,1,1,1,1,1,1,1,1,1,1,1,1,1,4
1,1,1,1,1,1,1,1,1,1,1,0,1,1,1,1
1,0,2,1,1,1,0,1,0,1,3,1,2,0,2,2
1,3,2,1,3,0,1,1,1,1,1,1,2,1,1,1
4,1,1,1,0,1,1,1,1,0,1,1,0,1,3,1
0,1,1,1,1,1,1,4,1,1,1,1,1,1,1,1
1,0,4,1,0,1,1,3,1,5,1,1,1,1,0,0
1,0,1,0,1,0,0,1,1,1,1,1,1,1,1,0
1,4,1,3,1,0,1,4,1,1,1,2,1,1,1,5
1,1,1,0,1,2,1,1,0,0,1,5,1,3,1,1
1,5,1,1,1,1,0,1,1,1,1,0,1,3,1,1
1,1,1,1,4,1,1,1,1,1,1,1,1,0,0,1
